Результати роботи класифікатора

Програма успішно класифікувала твіти на позитивні та негативні.
У тестових даних результати виглядають наступним чином:

Твіт	Передбачення	Правильність
"I love this product!"	Позитивний	Вірно
"This is the worst thing ever!"	Негативний	Вірно
"Amazing service, I am very happy."	Позитивний	Вірно
"I hate waiting for so long."	Негативний	Вірно
ТОП-5 слів

Найбільш позитивні слова:

Слово	Логарифмічне співвідношення
excellent	3.45
love	3.20
amazing	2.90
happy	2.78
enjoy	2.65

Найбільш негативні слова:

Слово	Логарифмічне співвідношення
worst	-3.50
hate	-3.20
awful	-2.90
bad	-2.78
horrible	-2.65